अ=अधिक,अनेक,अशी,असलयाचे,असलेल्या,असा,असून,असे
आ=आज,आणि,आता,आपल्या,आला,आली,आले,आहे,आहेत
ए=एक,एका
क=कमी,करणयात,करून
का=का,काम,काय,काही
की=की,किवा
के=केला,केली,केले
को=कोटी
गे=गेल्या
घे=घेऊन
जा=जात
झा=झाला,झाली,झाले,झालेल्या
टा=टा
ड=डॉ
त=तर,तरी,तसेच
ता=ता
ती=ती, तीन
ते=ते
तो=तो
त्या=त्या,त्याचा,त्याची,त्याच्या,त्याना,त्यानी,त्यामुळे
त्री=त्री
दि=दिली
दो=दोन
न=न
ना=नाही
निर्=निर्ण्य
प=पण,पम,परयतन
पा=पाटील
म=म
मा=मात्र,माहिती
मी=मी
मु=मुबी
म्ह=म्हणजे,म्हणाले,म्हणून
या=या,याचा,याची,याच्या,याना,यानी
ये=येणार,येत,येथील,येथे
ला=लाख
व=व
व्य=व्यकत
स=सर्व
सा=सागित्ले
सु=सुरू
ह=हजार
हा=हा
ही=ही
हे=हे
हो=होणार,होत,होता,होती,होते